timerglobal 250
timerfantome 20

CCCCCCCCCCCCCCCCCCCCC
CP      CCC        PC
C C C C C C C C C C C
C MMMMMMMMMMMMMMMMM C
C CMCMCMCMCMCMCMCMC C
C MMMMMMMMMMMMMMMMM C
C CMCMCMCMCMCMCMCMC C
C MMMMMMMMMMMMMMMMM C
C CMCMCMCMCMCMCMCMC C
C MMMMMMMMMMMMMMMMM C
C CMCMCMCMCMCMCMCMC C
CCC       E       CCC
C CMCMCMCMCMCMCMCMC C
C MMMMMMMMMMMMMMMMM C
C CMCMCMCMCMCMCMCMC C
C MMMMMMMMMMMMMMMMM C
C CMCMCMCMCMCMCMCMC C
C MMMMMMMMMMMMMMMMM C
C CMCMCMCMCMCMCMCMC C
CP      CCC        PC
CCCCCCCCCCCCCCCCCCCCC