timerglobal 500
timerfantome 10

CCCCCCCCCCCCCCCCCCCCC
C P   CMMMMMMMMMM   C
CCCCC CCCCCCCCC CCCCC
CE                 EC
CCCCCCCCC CCCCCCCCCCC
CMMMMM         MMMMMC
CCCCCCCCCCCCCCCCCCCCC